2 2 2 0 1 1 0 0 0 0 0 2 0 0 1 2 0 2 2 0
2 1 1 2 2 2 2 1 0 2 0 2 2 0 2 0 2 0 2 0
0 0 0 1 1 1 0 1 1 1 0 1 0 0 0 0 2 0 0 1
2 1 1 1 2 0 0 2 2 2 0 2 1 0 1 1 0 0 1 0
0 0 1 0 2 0 0 1 1 1 0 2 1 2 0 1 2 0 1 1
0 2 0 0 0 2 2 2 1 2 2 1 1 1 2 0 1 2 1 1
0 1 1 1 2 2 0 1 1 1 1 2 1 2 2 2 1 2 1 2
0 0 1 2 2 0 2 2 1 2 2 0 0 0 1 1 0 0 1 2
2 2 2 0 1 1 0 2 2 0 0 2 1 1 1 1 1 2 2 0
1 1 1 0 2 2 0 0 0 1 1 1 0 1 2 0 2 2 1 1
2 2 2 1 0 1 2 1 0 0 0 0 1 1 2 2 1 2 0 1
1 0 0 2 0 1 2 1 2 0 0 2 1 0 2 0 0 0 1 1
2 1 2 2 1 2 2 1 2 2 0 0 0 0 2 1 2 2 0 2
2 0 0 0 1 2 2 2 2 0 0 1 2 2 2 2 2 1 0 1
0 0 1 1 0 2 1 1 2 1 2 2 0 1 1 1 2 1 1 2
1 2 1 1 0 1 0 2 1 0 1 1 2 2 1 1 1 2 1 0
0 1 1 0 1 1 0 0 0 0 0 2 1 2 0 0 0 0 0 2
2 2 1 1 0 0 0 0 1 1 1 1 1 2 1 2 0 1 0 2
2 0 1 2 2 2 2 0 0 2 0 1 0 2 1 1 1 2 0 0
2 2 1 1 1 0 2 2 0 0 2 0 0 2 1 0 0 1 2 0
OBJECTS
{"pos":["6","13"],"imgNum":"1"}
{"pos":["5","12"],"imgNum":"1"}
{"pos":["4","11"],"imgNum":"1"}
{"pos":["8","17"],"imgNum":"5"}
{"pos":["7","18"],"imgNum":"5"}
{"pos":["5","5"],"imgNum":"10"}
{"pos":["5","5"],"imgNum":"10"}
{"pos":["4","4"],"imgNum":"10"}
{"pos":["8","4"],"imgNum":"10"}
{"pos":["7","11"],"imgNum":"0"}
{"pos":["8","14"],"imgNum":"0"}
{"pos":["3","8"],"imgNum":"3"}
{"pos":["4","7"],"imgNum":"2"}
{"pos":["9","12"],"imgNum":"2"}
{"pos":["4","16"],"imgNum":"2"}
{"pos":["5","10"],"imgNum":"1"}
{"pos":["6","8"],"imgNum":"1"}